##########
#........#
#.######.#
#......#.#
#.######.#
#.#......#
#.######.#
#........#
#........#
##########
