##########
#........#
#.#.#.#..#
#........#
#..#####.#
#........#
#.#.#.#..#
#........#
#........#
##########
