##########
#........#
#..#.....#
#..#.###.#
#..#.....#
#..#####.#
#........#
#.....#..#
#........#
##########
