##########
#........#
#...###..#
#........#
#.######.#
#........#
#..###...#
#........#
#........#
##########
