##########
#........#
#..####..#
#........#
#.#.##.#.#
#........#
#..####..#
#........#
#........#
##########
