##########
#........#
#.##.###.#
#.#....#.#
#.#....#.#
#.#....#.#
#.###.##.#
#........#
#........#
##########
