##########
#........#
#.######.#
#........#
#........#
#..####..#
#........#
#.######.#
#........#
##########
