##########
#........#
#..#####.#
#........#
#.#....#.#
#.#....#.#
#........#
#.#####..#
#........#
##########
