##########
#........#
#..####..#
#........#
#....#...#
#....#...#
#........#
#..####..#
#........#
##########
