##########
#........#
#.##..##.#
#.##..##.#
#........#
#........#
#.##..##.#
#.##..##.#
#........#
##########
