##########
#........#
#..####..#
#..#.....#
#..#.....#
#..####..#
#.....#..#
#.....#..#
#........#
##########
