##########
#........#
#...##...#
#..####..#
#...##...#
#........#
#..#####.#
#........#
#........#
##########
