##########
#........#
#....#...#
#...###..#
#..#####.#
#...###..#
#....#...#
#........#
#........#
##########
