##########
#........#
#..#..#..#
#........#
#..#..#..#
#........#
#..#..#..#
#........#
#........#
##########
