##########
#........#
#.#......#
#.#.####.#
#.#......#
#.#.####.#
#.#......#
#........#
#........#
##########
