##########
#........#
#..###...#
#..#.#...#
#..###...#
#........#
#...####.#
#........#
#........#
##########
