##########
#........#
#.######.#
#......#.#
#......#.#
#.######.#
#.#......#
#.#......#
#........#
##########
