##########
#........#
#......#.#
#.....##.#
#....##..#
#...##...#
#..##....#
#.##.....#
#........#
##########
