##########
#........#
#.#....#.#
#..#..#..#
#...##...#
#...##...#
#..#..#..#
#.#....#.#
#........#
##########
